Play = Play
Ratings = Ratings
SelectGame = SELECT GAME
Wheel = Wheel
Shop = Shop
Bonus = Bonus
Login = Login
EnterLogin = enter login...
EnterPassword = enter password...
LoginWithGoogle = Login with Google
Registration = Registration
LoginWithApple = Login with Apple
Logout = Logout
RepeatPassword = repeat password...
Sound = Sound
Language = Language
FieldIsEmpty = field is empty
UserExists = user with this login already exists
WrongLoginOrPassword = wrong login or password
LoginFail = login fail. try again later
MaxNameLength = maximum name length: 20 symbols
PasswordsDoNotMatch = passwords do not match
NameIsUnavailable = name is unavailable
Loading = loading
Day = Day
Tomorrow = Tomorrow
MoneySymbol = $
WatchAd = Watch Ad
Best = Best:
Spin = Spin
DailyBonus = daily bonus
WheelOfFortune = wheel of fortune
Exchange = Exchange
For = for
Reset = reset
OrGoTo = or go to
Register = Register
YourReward = your reward:
Get = get
swipe_to_start = swipe to start
swipe_to_rotate_counter = swipe left with two fingers to rotate the maze clockwise 90 degrees
level = level
tap_to_next = tap to next
swipe_to_rotate_clockwise = swipe right with two fingers to rotate the maze 90 degrees counterclockwise
not_bad = not bad
good_job = good job!
awesome = awesome!!!
completed = completed
Debug = Debug
on = on
off = off
rate_game = Rate game
show_leaderboards = Leaderboard
coins = Coins
heads = Heads
tails = Tails
backgrounds = Background
no_ads = Disable mandatory ads
