Play = Spiel
Ratings = Bewertung
SelectGame = SPIEL AUSWAEHLEN
Wheel = Rad
Shop = Geschäft
Bonus = Bonus
Login = Login
EnterLogin = login eingeben ...
EnterPassword = passwort eingeben...
LoginWithGoogle = Login mit Google
Registration = Anmeldung
LoginWithApple = Login mit Apple
Logout = Ausloggen
RepeatPassword = wiederhole das Passwort...
Sound = Klang
Language = Sprache
FieldIsEmpty = feld ist leer
UserExists = benutzer mit diesem Login existiert bereits
WrongLoginOrPassword = falsches Login oder Passwort
LoginFail = anmeldungsfehler. versuchen Sie es später erneut
MaxNameLength = maximale Namenslänge: 20 Symbole
PasswordsDoNotMatch = passwörter stimmen nicht überein
NameIsUnavailable = name ist nicht verfügbar
Loading = beladung
Day = Tag
Tomorrow = Morgen
MoneySymbol = €
WatchAd = Anzeigen ansehen
Best = Beste:
Spin = Rotieren
DailyBonus = Täglicher Bonus
WheelOfFortune = Schicksalsrad
Exchange = Austausch
For = für
Reset = zurücksetzen
OrGoTo = oder gehen zu
Register = Registrieren
YourReward = deine Belohnung:
Get = bekommen
swipe_to_start = zum Starten wischen
swipe_to_rotate_counter = Swipe mit zwei Fingern, um das Labyrinth im Uhrzeigersinn um 90 Grad zu drehen
level = eben
tap_to_next = Tippen Sie auf Weiter
swipe_to_rotate_clockwise = Streichen Sie mit zwei Fingern rechts, um das Labyrinth um 90 Grad gegen den Uhrzeigersinn zu drehen
not_bad = nicht schlecht
good_job = Gut gemacht!
awesome = genial!!!
completed = vollendet
Debug = Debug
on = an
off = aus
rate_game = Rate Spiel
show_leaderboards = Bestenliste
coins = Münzen
heads = Köpfe
tails = Schwänze
backgrounds = Hintergrund
no_ads = Deaktivieren Sie obligatorische Anzeigen
restore_purchases = Einkäufe wiederherstellen
you_have = Du hast
continue = Fortsetzen
not_enough_money = Nicht genug Geld
buy = Besorgen
no_internet_connection = Keine Internetverbindung
failed_to_load_lead = Leaderboard konnte nicht geladen werden
oops = Hoppla!!
service_connection_error = Fehler beim Anschließen an Dienste
rotation_possibility_text = Wenn diese Anzeige am Anfang des Niveaus erscheint, kann das Labyrinth gedreht werden
rate_dialog_title = Rate Spiel
rate_dialog_text = Möchten Sie mein Spiel bewerten?
rate_yes = Ja sicher!!!
rate_not_now = Später
rate_never = noch nie
purchase = Kaufen
mandatory_ads_disabled = Deaktivieren Sie obligatorische Anzeigen
coins_alt = Münzen
dark_theme = Dunkles Thema
dark_theme_available = Super! Das dunkle Thema ist jetzt verfügbar. Sie können es im Menü Einstellungen auswählen.
smth_went_wrong = Etwas ist schief gelaufen
