Play = Jogar
Ratings = Avaliações
SelectGame = SELECIONE O JOGO
Wheel = Roda
Shop = Loja
Bonus = Bonus
Login = Login
EnterLogin = insira o login ...
EnterPassword = digite a senha...
LoginWithGoogle = Entrar com o Google
Registration = Cadastro
LoginWithApple = Entrar com o Apple
Logout = Sair
RepeatPassword = repita a senha...
Sound = Som
Language = Língua
FieldIsEmpty = campo está vazio
UserExists = usuário com este login já existe
WrongLoginOrPassword = login ou senha errada
LoginFail = falha de login. tente mais tarde
MaxNameLength = comprimento máximo do nome: 20 símbolos
PasswordsDoNotMatch = as senhas não coincidem
NameIsUnavailable = nome indisponível
Loading = carregando
Day = dia
Tomorrow = Amanhã
MoneySymbol = €
WatchAd = Assistir a anúncios
Best = Melhor:
Spin = Girar
DailyBonus = Bônus diário
WheelOfFortune = roda da fortuna
Exchange = Troca
For = por
Reset = redefinir
OrGoTo = ou vá para
Register = Registrar agora
YourReward = sua recompensa:
Get = pegue
swipe_to_start = deslize para começar
swipe_to_rotate_counter = Swipe saiu com dois dedos para girar o labirinto no sentido horário 90 graus
level = nível
tap_to_next = Toque para o próximo
swipe_to_rotate_clockwise = deslize bem com dois dedos para girar o labirinto 90 graus no sentido anti-horário
not_bad = nada mal
good_job = bom trabalho!
awesome = impressionante!!!
completed = concluído
Debug = Debug
on = sobre
off = fora
rate_game = Taxa de jogo
show_leaderboards = Entre os melhores
coins = Moedas
heads = Cabeças
tails = Caudas
backgrounds = Fundo
no_ads = Desativar anúncios obrigatórios
restore_purchases = Restaurar compras
you_have = Você tem
continue = Continuar
not_enough_money = Dinheiro insuficiente
buy = Comprar
no_internet_connection = Nenhuma conexão com a Internet
failed_to_load_lead = Falha ao carregar o leaderboard
oops = Oops !!
service_connection_error = Erro ao conectar-se aos serviços
rotation_possibility_text = Este indicador mostra que o labirinto pode ser girado
rate_dialog_title = Taxa de jogo
rate_dialog_text = Você quer avaliar meu jogo?
rate_yes = Sim, claro!!!
rate_not_now = Mais tarde
rate_never = Nunca
purchase = Comprar
mandatory_ads_disabled = Desativar anúncios obrigatórios
coins_alt = Moedas
dark_theme = Tema oscuro
dark_theme_available = Super! O tema escuro está agora disponível. Você pode escolher no menu Configurações.
smth_went_wrong = Algo deu errado
char_replic_1 = [Empty]
char_replic_2 = [Empty]
char_replic_3 = [Empty]
char_replic_4 = [Empty]
char_replic_5 = [Empty]
char_replic_6 = [Empty]
