Play = Jugar
Ratings = Calificación
SelectGame = SELECCIONA UN JUEGO
Wheel = Rueda
Shop = Tienda
Bonus = Bonus
Login = Login
EnterLogin = ingrese login ...
EnterPassword = introducir la contraseña...
LoginWithGoogle = Iniciar sesión con Google
Registration = Registro
LoginWithApple = Iniciar sesión con Apple
Logout = Cerrar sesión
RepeatPassword = repite la contraseña...
Sound = Sonido
Language = Idioma
FieldIsEmpty = el campo esta vacio
UserExists = el usuario con este inicio de sesión ya existe
WrongLoginOrPassword = usuario o contraseña incorrectos
LoginFail = carga fallida. inténtalo de nuevo más tarde
MaxNameLength = longitud máxima del nombre: 20 símbolos
PasswordsDoNotMatch = las contraseñas no coinciden
NameIsUnavailable = el nombre no está disponible
Loading = cargando
Day = día
Tomorrow = Mañana
MoneySymbol = €
WatchAd = Ver anuncios
Best = Mejor:
Spin = Girar
DailyBonus = Bonus diario
WheelOfFortune = rueda de la fortuna
Exchange = Intercambiar
For = por
Reset = reiniciar
OrGoTo = o ir a
Register = Registrarse
YourReward = tu recompensa:
Get = obtener
swipe_to_start = [Empty]
swipe_to_rotate_counter = [Empty]
level = [Empty]
tap_to_next = [Empty]
swipe_to_rotate_clockwise = [Empty]
not_bad = [Empty]
good_job = [Empty]
awesome = [Empty]
completed = [Empty]
Debug = Debug
on = [Empty]
off = [Empty]
rate_game = [Empty]
show_leaderboards = [Empty]
coins = [Empty]
heads = [Empty]
tails = [Empty]
backgrounds = [Empty]
no_ads = [Empty]
